			 B X Y L M D B Y X
			 C D X S O E C Z A
			 V A L U E M M L O
			 Y T S C E P X P A
			 C A S C V L Y Q C
			 L A W E I O N S C
			 Z M S S R Y W Z E
			 X A M S U E V R P
			 M B C Y S E U T T